% ----------- A
ABC  : Automatic Bias Control
ADC  : Analog to Digital Converter
AEQ  : Adaptative EQualizer
AI   : Anomaly Indicator
AGC  : Automatic Gain Control
APD  : Avalanche Photo-Diode
AN   : Access Network
ANSI : American National Standard Institute
ASE  : Amplified Spontaneous Emission
ASK  : Amplitude Shift Keying
ATM  : Asynchronous Transfer Mode
AUC  : Area Under the Curve
AWG  : Arbitrary Waveform Generator
AWGN : Additive White Gaussian Noise

% ----------- B
BBA  : Basic Belief Assignment
BEP  : Bit Error Probability
BER  : Bit Error Ratio
BFGS : Broyden Fletcher Goldfarb Shanno algorithm
BIBO : Bounded Input Bounded Output
BL   : Bend Loss
BPD  : Balanced Photo Detector
BS   : Beam Splitter
BSC  : Belief Shift Clustering

% ----------- C
CART : Classfication And Regression Trees
CCM  : Credal C-Means
CD   : Coherent Detection
CDC  : Chromatic Dispersion Compensation
CDMA : Code Division Multiple Access
CDR  : Clock Data Recovery
CHAID: CHi squared Automatic Interaction Detector
CDF  : Cumulative Density Function
CKT  : circuit
CMA  : Constant Modulus Algorithm
CMT  : Coupled Mode Theory
CN   : Campus Network
CNN  : Convolutionnal Neural Network
CPE  : Carrier Phase Estimation
CPR  : Carrier Phase Recovery
CQF  : Conjugate Quadrature Filter
CR   : Clock Recovery
CRF  : Coherent Receiver Front-end
CRI  : Credal Rand Index
CS   : Cycle Slips
CSI  : Channel State Informations
CUT  : Channel Under Test
CW   : Continuous Wave
CWE  : Coupled Wave Equations

% ----------- D
DA   : Drive Amplifier
DAC  : Digital to Analog Converter
DAMA : Demand-Assignment Multiple-Access
DBP  : Digital Back Propagation
DCF  : Double Clad Fibre
DCF  : Dispersion Compensated Fibre
DCM  : Dispersion Compensating Module
DCR  : Direct Conversion Receiver
DEC  : Dynamic Evidential Clustering
DFB  : Distributed FeedBack
DGD  : Differential Group Delay
DMD  : Differential Mode Delay
DOP  : Degree Of Polarisation
DP   : Dual Polarisation
DPD  : Digital Pre Distorsion
DQPSK: Differential Quadrature Phase Shift Keying
DSF  : Dispersion Shifted Fibre
DSO  : Digital Sampling Oscilloscope
DSO  : Digital Storage Oscilloscope
DSP  : Digital Signal Procesing
DST  : Dempster-Shafer Theory
DUT  : Device Under Test
DWT  : Discrete Wavelet Transform

% ----------- E
EAM  : Electro-Absorption Modulator
ECL  : External Cavity Laser
ECM  : Evidential C-Means
ECOC : European Conference on Optical Communication
ECOC : Ensemble Complet d'Observables qui Commutent
EDFA : Erbium Doped Fibre Amplifier
EGMM : Evidential Gaussian Mixture Model
EGN  : Enhanced Gaussian Noise
ELPF : Electrical Low Pass Filter
EO   : Eye Openning
EOM  : Electro Optic Modulator
ER   : Extinction Ratio
ESS  : Explained Sum of Squares
ETDM : Electrical Time Division Multiplexing
EVM  : Error Vector Magnitude

% ----------- F
FBG  : Fibre Bragg Grating
FCM  : Fuzzy C-Means
FDDI : Fiber Distributed Data Interface
FEC  : Forward Error Correction
FF   : Frequency Flat
FFT  : Fast Fourier Transform
FIR  : Finite Impulse Response
FITL : Fiber In The Loop
FN   : Frequency Noise
FO   : Frequency Offset
FOC  : Frequency Offset Compensation
FoM  : Figure of Merit
FON  : Fourth Order Noise
FRCP : Frequency Resolved Calibration Procedure
FS   : Frequency Selective
FTTH : Fiber To The Home
FWHM : Full Width Half Maximum
FWM  : Four Waves Mixing

% ----------- G
G    : Gigabits/s
GD   : Gradient Descent
GEQ  : Gain EQualiser/ation
GFF  : Gain Flatening Filter
GN   : Gaussian Noise
GNB  : Gaussian Naive Bayes
GPON ; Gigabit Passive Optical Network
GSNR : Generalised Signal to Noise Ratio
GSOP : Gram-Schmidt Orthogonalization Procedure
GVD  : Group Velocity Dispersion

% ----------- H
HDLC : High level Data Link Control
HHG  : High order Harmonic Generation
HHI  : Heinrich-Hertz Institute (Fraunhofer HHI)
HiBi : High Birefringence
HSPON: High Speed Passive Optical Network

% ----------- I
ICR  : Integrated Coherent Receiver
ID3  : Iterative Dichotomiser 3
IEC  : International Electrotechnical Commission
IF   : Intermediate Frequency
IG   : Information Gain
IGN  : Incohrent Gaussian Noise
IL   : Insertion Loss
IP   : Internet Protocol
IPA  : Interrelation Profile Analysis
IQM  : I-Q Modulator
ISI  : Inter-Symbol Interference
ISRS : Inter-channel Stimulated Raman Scattering
ITLA : Integrable Tunable Laser Assembly 

% ----------- J
JLT  : Journal of Lightwave Technologies
JQE  : Journal of Quantum Electronics

% ----------- K

% ----------- L
LAN  : Local Area Network
LBFGS: Limitied Memory BFGS
LCC  : Liquid Crystal Cell
LCoS : Liquid Crystal on Silicon
LD   : Laser Diode
LDS  : Laser Diode Stabilizer
LEAF : Large Effective Area Fibre
LL   : Log Likelihood
LMA  : Large Mode Area
LMS  : Least Mean Square
LNEO : Lithium Niobate Electro Optic
LO   : Local Oscillator
LOGO : Local Optimization Global optimization
LS   : Least Squares
LWN  : Locally white noise
LWR  : Locally Weighted Regression

% ----------- M
MAN   : Metropolitan Area Network
MARS  : Multivariate Adaptative Regression Splines
MB    : Margin Boundaries
MBL   : Micro Bending Loss
MBS   : Multi-Band System
MCF   : Multiple Core Fibre
MCI   : Multi Channel Interference
MEMS  . Micro Electro Mechanical Structure  
MI    : Modulation Instabilities
MIMO  : Multiple Input Multiple Output
MLP   : Multi Layers Perceptron
MONET : Mulit-wavelength Optican NETworking
MPS   : Modulation Phase Shift
MQW   : Multi Quantum Well
MSS   : Modified Sum of Squares
MZ    : Mach-Zehnder
MZM   : Mach-Zehnder Modulator
M2M   : Machine To Machine

% ----------- N
NA    : Numerical Aperture
NEB   : Noise Equivalent Bandwidth
NEP   : Noise Equivalent Power
NLC   : Non Linear Compensation
NLE   : Non Linear Equalizer
NLI   : Non Linear Interference
NLPN  : NonLinear Phase Noise
NLSE  : Non Linear Schrodinger Equation
NLPR  : Non Linear Phase Rotation
NN    : Neural Network
NRD   : Non Residual Dispersion
NRZ   : Non Return to Zero
NTT   : Nippon Telegraph and Telephone
NZDSF : Non-Zero Dispersion Shifted Fibre

% ----------- O
OADM : Optical Add-Drop Multiplexer
OAM  : Orbital Angular Momentum
OBPF : Optical Band Pass Filter
ODN  : Optical Distribution Network
OE   : Optics Express
OECC : OptoElectronic and Communications Conference
OEI  : Optical Emission Interface
OEO  : optical-electrical-optical
OFC  : Optical Fiber Communications
OFDM : Orthogonal Frequency Division Multiplex
OLT  : Optical Line Terminal
OMA  : Optical Monitoring and Analysis
OMS  : Optical Multiplex Section
ONF  : Open Networking Foundation
ONT  : Optical Network Terminal
ONU  : Optical Network Unit
OOK  : On-Off Keying
OPM  : Optical Performance Monitoring
OPO  : Optical Parametric Oscillator
ORI  : Optical Reception Interface
OSA  : Optical Spectrum Analyser
OSI  : Open System Interconnect
OSNR : Optical Signal to Noise Ratio
OTN  : Optical Transport Network
OTS  : Optical Transmission System
OTDR : Optical Time Domain Reflectometry
OTDM : Optical Time Division Multiplexing
OXC  : Optical Cross Connect

% ----------- P
PAM  : Pulse Amplitude Modulation
PBS  : Polarisation Beam Splitter
PBG  : Photonic Band Gap
PBNE : Pass Band Narrowing Estimator
PC   : Polarisation Controller
PCA  : Principal Component Analysis
PCS  : Probabilistic Constellation Shaping
PDM  : Polarisation Division Multiplexing
PDM  : Polarisation Dependent Modulation
PER  : Polarisation Extinction Ratio
PDF  : Probability Distribution Function
PDG  : Polarisation Dependent Gain
PDL  : Polarisation Dependent Loss
PLL  : Phase Locked Loop
PM   : Polarization Maintaining
PM   : Polarization Multiplexed/ing
PMD  : Polarisation Mode Dispersion
PMF  : Polarisation Maintaining Fiber
PNAS : Proceedings of the National Academy of Sciences
PON  : Passive Optical Network
PP   : Power Penalty
PPE  : Power Profile Estimator
PPLN : Periodically Poled Lithium Niobate
PPP  : Point to Point Protocol
PS   : Polarisation State
PSBT : Phase Shaped Binary Transmission
PSC  : Photonics in Switching and Computing
PSCF : Pure Silica Core Fibre
PSK  : Phase Shift Keying 
PSP  : Principle State of Polarisation
PWM  : Pulse Width Modulation

% ----------- Q
QCL  : Quantum Cascade Laser
QoE  : Quality of Experience
QoS  : Quality of Service
QoT  : Quality of Transmission
QPM  : Quasi Phase Matching
QPSK : Quadrature Phase Shift Keying

% ----------- R
RAN  : Regional Area Network
RCM  : Reversed Channel Method
RD   : Radius Directed
ReLU : Rectified Linear Unit
RIN  : Relative Intensity Noise
RMSE : Root Mean Squared Error
RNN  : Recursive Neural Network
ROC  : Receiver Operating Characteristics
ROADM: Reconfigurable Optical Add-Drop Multiplexer
RRC  : Root-Raised Cosine
RS   : Random Sampling
RSOA : Reflective Semiconductor Optical Amplifier
RTO  : Real Time Oscilloscope

% ----------- S
SAM   : Spinning Angular Momentum
SCI   : Self Channel Interference
SCM   : Sub Carrier Multiplexing
SDH   : Synchronous Digital Hierarchy
SDM   : Spatial Division Multiplexing
SeLU  : Scaled exponential Linear Unit
SGD   : Stochastic Gradient Descent
SHB   : Spectral Hole Burning
SHG   : Second Harmonic Generation
SI    : System Identification
SLC   : Subscriber Loop Carrier
SMF   : Single Mode Fibre
SMSR  : Single Mode Suppression Ratio
SNN   : Self normalising Neural Network
SNR   : Signal to Noise Ratio
SOA   : Semiconductor Optical Amplifier
SON   : Second Order Noise
SONET : Synchronous Optical NETwork
SoP   : State of Polarisation
SOTA  : State Of The Art
SPIDER: Spectral Phase Interferometry for Direct Electric field Reconstruction
SPM   : Self Phase Modulation
SRRC  : Square Root-Raised Cosine
SRSI  : Self Reference Spectral Interferometry
SSA   : Stokes Space Algorithm
SSB   : Single-Side Band
SSF   : Split-Step Fourier
SSMF  : Standard Single Mode Fibre
SVM   : Support Vector Machine

% ----------- T
TAT  : Trans Atlantic Telephone
TBF  : Theory of Belief Functions
TCP  : Transmission Control Protocol
TDL  : Temperature Dependent Loss
TDM  : Time Division Multiplexing
TDFA : Thulium Doped Fiber Amplifier
TEC  : Thermal Expansion Coefficients
TECM : Transfer Evidential C-Means
THG  : Third Harmonic Generation
TIA  : Trans-Impedance Amplifier
TIA  : Telecommunications Industry Association
TLD  : Tunable Laser Diode
TOC  : Thermo Opitc Coefficients
TS   : Training Sequence
TSS  : Total Sum of Squares

% ----------- U
UT   : Uncompensated Transmission

% ----------- V
VCSEL: Vertical Cavity Surface Emitting Laser
VM   : Vanishing Moments
VNLE : Volterra NonLinear Equalizer
VOA  : Variable Optical Attenuator
VTD  : Virtual Topology Design
VUS  : Volume Under Surface

% ----------- W
WAN  : Wide Area Network
WADM : Wavelength Add/Drop Multiplexer
WDM  : Wavelength Division Multiplexing
WSS  : Wavelength Selective Switching
WGS  : Whispering Gallery Mode

% ----------- X
XCI : Cross Channel Interference
XPM : Crossed Phase Modulation
XPW : Crossed Polarized Wave
XT  : Cross Talk

% ----------- Y

% ----------- Z
ZFE  : Zero Forcing Equalizer


% ----------- ***
*PSPC : Projets de R&D Structurants Pour la Compétitivité
